CACCCCCACCCCCCCCCC
CCAAAAAAAAAAAAAAAC
CCACCCCCCCCCCCCACC
CCACCCCCCCCCCCCACC
CCACCRRRRCRRRCCACC
CCACCRCCCCCCRCCACC
CCACCRHCCCCCRRCACC
CCACCRRRRRRRRCCACC
CCACCCCCCCCCCCCACC
CCACCCCCCCCCCCCACC
CCAAAAAACCAAAAAACC
CCCCCCCCCCCCCCCACC
CCCCCCCCCCCCCCCCCC
CCCCCCCCCCCCCCCCCC
CCCCCCCCCCCCCCCCCC
