AAAAAAAAAAAAAAAAAAAAAA
ARCCCCCCCACCACRACCCCCA
ACCATACCTCTTATACCAAAAA
ACACCCRCCCCCATCCCCACCA
AACCACCACCACCCCCCAACCA
AACCCCTCCRCRCRCAACCTCA
ACCCCCTCCCCCCCCCTCTCCA
ACRCCCRCCCCCCCRCCCARCA
ACCCCRCACCCCCCCCACACCA
ACRACACCCCRCCCCRACCCCA
ARCCATCCAACTCCRCCCRCAA
ACTCTCTCCCACCACCCCCACA
ACCCCATCACCCACCCCRRTCA
ATTCACACRACTCCCCCTCCCA
ARHCTACCTCCATCCCACCCCA
ACRRCCCCCTTCCCCCCCCCCA
AAAAAAAAAAAAAAAAAAAAAA
AAAAAAAAAAAAAAAAAAARCC
CCCTCCCTAACCCCCACCCACC
TCCCCCCCCCCCCACCRCAACC
