AAAAAAAAAAAAAAAAAAAAAA
ACACCATCRCCCRACCRATCCA
AACTCTTAATCRCTRCACARAA
AACACTTCCCRAACCCCCRCAA
ACCCCCATCRRCCRCRRCTRRA
ATTCAAACCCTATACAAACCTA
AACCRTATCRTCTCCTTTCAAA
ACCCCCCAACAARCAAACARCA
ARATCCAACACCCCARRCAACA
AACCCTRACCRATTACCACTCA
ATAACTCRACCCAACCRCCCCA
ATCCCACRACCRRATCCCCAAA
ARRAACCTRRCCATACRTACCA
ARACTAAARTRCCACARCTACA
AACCCCACRCHCRTACATCCRA
ACACATAACCCTCRAATACCAA
AAAAAAAAAAAAAAAAAAAAAA
AAAAAAAAAAAAAAAAAAARCC
CCCTCCCTAACCCCCACCCACC
TCCCCCCCCCCCCACCRCAACC
