AAAAAAAAAAAAAAAAAA
AACCTTCACCCCCCAAAA
AACACCCACACACCCAAA
ATCAACCAAACACCCCAA
ACCAAACCACCAACACCA
ACCATTCCACCACCACAA
ATCATCCCCCCAACACAA
ATAATTTCCCAACCCAAA
ACAATTTTCAACCACCCA
AAAATAAAACCCCAACCA
AAAAAAHCCCCCCAAAAA
CCCCCCCCCCCCCCCCCC
CCCCCCCCCCCCCCCCCC
CCCCCCCCCCCCCCCCCC
CCCCCCCCCCCCCCCCCC
