CCCCCCCCCCCCCCCCCCCCCC
CCCCCCCCCCCCCTCCCCCCCC
CCCCACCAATTTCACCCCCCCC
CCCCCTTAAAAARAATCCCCCC
CCCCATAAAAAAAAAAAACCCC
CCCCTAAAAAAAAAAAATTCCC
CCATAAAAAAAAAAAAAAATTC
CCTAAAAAAAAAAAAAAATCCC
CCTAAAAAAAAAAAAAAAACTC
CCTAAAAAAAHAAAAAAATTCC
CCAAAARAAAAAAAAAATACCC
CCCAAAAAAAAAAAAAAACCCC
CCCAAAAAAAAAAAAAATCCCC
CCTTAAAAAAAAAAAAAAACCC
CCCATAAAAAAAAAAAACCCCC
CCCCCAAAAAAAAAAACCCCCC
CCCCCTAAAAAAAAATCCCCCC
CCCCCCTAAAAAATATCCCCCC
CCCCCCCCCTTATCCCCCCCCC
CCCCCCCCCCCCCCCCCCCCCC
