CCCAACCCCCCCCCCCCC
CCCCTTCCCCCCCCCCCC
CCCACCCCCCCCCCCCCC
TTCACCCCCCCCCCCCCC
TCCAAACCCCCCCCCCCC
TCCACTCCCCCCCCCCCC
TTCCCCCHCCCCCCCCCC
TTTACCCCCCCCCCCCCC
CCCCCCCCCCCCCCCCCC
CCCCCCCCCCCCCCCCCC
CCCCCCCCCCCCCCCCCC
CCCCCCCCCCCCCCCCCC
CCCCCCCCCCCCCCCCCC
CCCCCCCCCCCCCCCCCC
CCCCCCCCCCCCCCCCCC