CCCAACCCCC
CCCCTTCCCC
CCCACCCCCC
TTCACCCCCC
TCCAAACCCC
TCCACTCCCC
TTCCCCCCCC
TTTACCCCCC
