AAAAAAAAAAAAAAAAAAAAAA
ACCCCCCCCHCACCCCCCCCCA
ACCCCCCAAAAACCCCCCCCCA
ACCCCCCACCCCCCCCCCCCCA
ACCCCCCAAAAAAAAACCCCCA
ACCCCCCCCCCCCCCACCCCCA
ACCCCAAAAAAAAAAACCCCCA
ACCCCACCCCCCCCCCCCCCCA
ACCCCAAAAAAAAAAAAACCCA
ACCCCCCCCCCCCCCCCACCCA
ACCCAAAAAAAAAAAAAACCCA
ACCCACCCCCCCCCCCCCCCCA
ACCCAAAAAAAAAAAAAAACCA
ACCCACACACACACACACACCA
ACCCACACACACACACACACCA
ACCCCCCCCCCCCCCCCCCCCA
AAAAAAAAAAAAAAAAAAAAAA
AAAAAAAAAAAAAAAAAAARCC
CCCTCCCTAACCCCCACCCACC
TCCCCCCCCCCCCACCRCAACC
