AAAAAAAAAAAAAAAAAAAAAA
ACTCCTCCCTCCACCTCCTRAA
ACARCTCCCCCCCCCARCAACA
AACAARCACCCCTCATCAARAA
ATARACTCTAAACACRACAAAA
ARTCCCTCACCARCATTCCTTA
ACCCATCCCTCCARCCCCRRTA
ATCCTCTCCACACRAAATATCA
AAARATCRCAAACATTCAACCA
AACTAACCTRTCATCACCCACA
AATCRCACTCACTAACAAARCA
ACCCACTCACARCATRARACRA
ACTCAARACCCCCACRAAARTA
ACRCCCCTCCCAACRCRAATRA
AARRRRCTAACAAATCACCTHA
AACATTCCCCACCATCAACRRA
AAAAAAAAAAAAAAAAAAAAAA
AAAAAAAAAAAAAAAAAAARCC
CCCTCCCTAACCCCCACCCACC
TCCCCCCCCCCCCACCRCAACC
