AAAAAAAAAAAAAAAAAAAAAA
ACACRCCRCARCCARAACACCA
ACAARTAACTTTRARRTATCRA
AACCCTCCRCTACCCTTTACCA
AACCCTCCACRCACTCCCACRA
ACRTCCTTCACCCAARCACCCA
ACCCTCCCCCTCCAACCCCCCA
ACTCCAAATCACCACCTCCCCA
ACRRTCCCCCRCCCCCTCACCA
ACAARRCTCTAACACCRCRRAA
ACRCCACCAACCCCACATCACA
ACCCACRCACCAACCCCCCTTA
ARCACCACCCRRCTACCRCCTA
ACCTTCCARACRCTCAARCCAA
AHCTCTACACCCCCCCCCACCA
ACCCCCATCCCTCCCRCTCACA
AAAAAAAAAAAAAAAAAAAAAA
AAAAAAAAAAAAAAAAAAARCC
CCCTCCCTAACCCCCACCCACC
TCCCCCCCCCCCCACCRCAACC
