CACCTCCTACCRCCAACA
CAAAACAAAAACCRAACA
TAAACAAATACRCAACCT
RATAARACACTCCACRRR
RCAATRTRTTCAARCARA
AARTHCAACCACCCCRCC
CACAACCCRCCRAACATR
TTTTCARTCRRATRAACT
ACACCRCCCCCCCCACTC
CRCACCCCRARACCACCC
RRCARRTACCCCCCCCCR
CCCCCCCCCCCCCCCCCC
CCCCCCCCCCCCCCCCCC
CCCCCCCCCCCCCCCCCC
CCCCCCCCCCCCCCCCCC
