AAAAAAAAAAAAAAAAAAAAAA
ACCCCCCCACCCCCCCACCCCA
ACCCCCCCACCCCCCCACCCCA
ACCCACCCACCCACCCACCCCA
ACCCACCCACCCACCCACCCCA
ACCCACCCACCCACCCACCCCA
ACCCACCCACCCACCCACCCCA
ACCCACCCACCCACCCACCCCA
ACCCACCCACCCACCCACCCCA
ACCCACCCACCCACCCACCCCA
ACCCACCCACCCACCCACCCCA
ACCCACCCACCCACCCACCCCA
ACCCACCCACCCACCCACCCCA
ACCCACCCACCCACCCACCCCA
ACCCACCCCCCCACCCCCCCCA
AHCCACCCCCCCACCCCCCCCA
AAAAAAAAAAAAAAAAAAAAAA
AAAAAAAAAAAAAAAAAAARCC
CCCTCCCTAACCCCCACCCACC
TCCCCCCCCCCCCACCRCAACC
