CACCCCCCCACCCCCCAC
AACCCCCCCARCCRCTAT
CTCTCTCCAACACTCCRA
TCACRCCRRCCACTCCCC
ARCRATARARCCTATTCA
CATCCTARCCCCCCCCAA
CCCTRCACACACCCATCA
CHCCCCCTCCCCACCACC
CCCCCCCCATRCCCCCTA
ATCCACATCTRACAACAC
ACACTACACARCACTCCC
CCTCCCCCCCAACACACA
ACTCTARCRCCCCRTCCC
CCCCCCCCCCCCCCCCCC
CCCCCCCCCCCCCCCCCC
