AAAAAAAAAAAAAAAAAAAAAA
ACCCCCCCCCHACCCCCCCCCA
ACCCCCAAAAAACCCCCCCCCA
ACCCCCACCCCCCCCCCCCCCA
ACCCCCAAAAAAAAAACCCCCA
ACCCCCCCCCCCCCCACCCCCA
ACCCAAAAAAAAAAAACCCCCA
ACCCACCCCCCCCCCCCCCCCA
ACCCAAAAAAAAAAAAAACCCA
ACCCCCCCCCCCCCCCCACCCA
ACCAAAAAAAAAAAAAAACCCA
ACCACCCCCCCCCCCCCCCCCA
ACCAAAAAAAAAAAAAAAACCA
ACCACACACACACACACACCCA
ACCACACACACACACACACCCA
ACCCCCCCCCCCCCCCCCCCCA
AAAAAAAAAAAAAAAAAAAAAA
AAAAAAAAAAAAAAAAAAARCC
CCCTCCCTAACCCCCACCCACC
TCCCCCCCCCCCCACCRCAACC
