AAAAAAAAAAAAAAAAAAAAAA
ACCCCCCCCCCCCCCCCCCCCA
ACCCCCCCCCCCCCCCCCCCCA
ACCCCCCCCCCCCCCCCCCCCA
ACCCCCCCCCCCCCCCCCCCCA
ACCCCCCCCCCCCCCCCCCCCA
ACCCCCCCCCCCCCCCCCCCCA
ACCCCCCCCCCCCCCCCCCCCA
ACCCCCCCCCCCCCCCCCCCCA
ACCCCCCCCCCCHCCCCCCCCA
ACCCCCCCCCCCCCCCCCCCCA
ACCCCCCCCCCCCCCCCCCCCA
ACCCCCCCCCCCCCCCCCCCCA
ACCCCCCCCCCCCCCCCCCCCA
ACCCCCCCCCCCCCCCCCCCCA
ACCCCCCCCCCCCCCCCCCCCA
AAAAAAAAAAAAAAAAAAAAAA
AAAAAAAAAAAAAAAAAAARCC
CCCTCCCTAACCCCCACCCACC
TCCCCCCCCCCCCACCRCAACC
