ACACCATTRTACCCCAAC
CACCACTCACACCTCCAC
AACCAACCTATAAACCAC
CCCAACAACCCCAARARC
CARAAATCCACAAAAAAC
ACTACRCCCAACCARRCA
CRTARRRRCCCTCRCCTC
TATTCCHRRCRACAAACC
ACACATCCACRCTCRCCA
CCCTACCTRRATACARRC
ARRRTAACCCCCTCRRTT
CCCCCCCCCCCCCCCCCC
CCCCCCCCCCCCCCCCCC
CCCCCCCCCCCCCCCCCC
CCCCCCCCCCCCCCCCCC
