AAAAAAAAAAAAAAAAAA
AACCTTCACCCCCCAAAA
AACACCCACACACCCAAA
ATCAACCAAACACCCCAA
ACCAAACCACCAACACCA
ACCATTCCACCACCACAA
ATCATCRCCCCAACACAA
ATAATTRRCCAACCCAAA
ACCATTTTCAACCACCCA
AATATAAAACCCCAACCA
AAAAAAHCCCCRCAAAAA
CCCCCCCCCCCCCCCCCC
CCCCCCCCCCCCCCCCCC
CCCCCCCCCCCCCCCCCC
CCCCCCCCCCCCCCCCCC
