AAAAAAAAAAAAAAAAAAAAAA
AACCRCCRCCACCACRCCRTCA
AACRCCCTCCCCCTACCCCCCA
AARACCTTACCCACACACCRCA
ACCCCCTCCTCCCTCCACAACA
ATCCCCACCCCCCAAAACCCAA
ACRCCTCTRCCCTCCCCCCTCA
AACTCTCCACACTCATCCTCRA
ACACCCCCCCCCCCACCCCCCA
ACHCCCCCCACCCCCCCCCARA
ACCCRCCCCCCRCCCRARTCCA
ACRACCACACCCCCCCACCTCA
ACCCRRCCACACCCCCCCCATA
ACCTAACCCCTACCCCCCCTAA
ACCCCCCACCAAACCCCACCCA
ACCRACCCACCCACCCCCACCA
AAAAAAAAAAAAAAAAAAAAAA
AAAAAAAAAAAAAAAAAAARCC
CCCTCCCTAACCCCCACCCACC
TCCCCCCCCCCCCACCRCAACC
