AAAAAAAAAAAAAAAAAAAAAA
ACCCCCCCCCCACCCCCCCCCA
ACCCCCCCCAAACCCCCCCCCA
ACCAAAAAAAAAAAAAAAACCA
ACCACCCCCCCCCCCCCCACCA
ACCACCCCCCCCCCCCCCACCA
ACCACCRRRCRRRRRRCCACCA
ACCACCRCCRCRCCCRCCACCA
ACCACCRCCRRRCCCRCCACCA
ACCACCRCCCCHCCCRCCACCA
ACCACCRRRRRRRRRRCCACCA
ACCACCCCCCCCCCCCCCACCA
ACCACCCCCCCCCCCCCCACCA
ACCAAAAAAACCCAAAAAACCA
ACCCCCCCCCCCCCCCCCCCCA
ACCCCCCCCCCCCCCCCCCCCA
AAAAAAAAAAAAAAAAAAAAAA
AAAAAAAAAAAAAAAAAAARCC
CCCTCCCTAACCCCCACCCACC
TCCCCCCCCCCCCACCRCAACC
