AAAAAAAAAAAAAAAAAAAAAA
ACCCCCCCACCCCCCCACCCCA
ACCCCCCCACCCCCCCACCCCA
ACCCACCCACCCACCCACCCCA
ACCCACCCACCCACCCACCCCA
ACCCACCCACCCACCCACCCCA
ACCCACCCACCCACCCACCCCA
ACCCACCCACCCACCCACCCCA
ACCCACCCACCCACCCACCCCA
ACHCACCCACCCACCCACCCCA
ACCCACCCACCCACCCACCCCA
AAAAACCCACCCACCCACCCCA
ACACACCCACCCACCCACCCCA
ACCCACCCACCCACCCACCCCA
ACCCACCCCCCCACCCCCCCCA
ACCCACCCCCCCACCCCCCCCA
AAAAAAAAAAAAAAAAAAAAAA
AAAAAAAAAAAAAAAAAAARCC
CCCTCCCTAACCCCCACCCACC
TCCCCCCCCCCCCACCRCAACC
