137 139 140 139 137 135 131 127 121 115 109 102 95 87 80 71 63 55 46 37 28 19 
147 149 150 149 147 144 140 135 130 123 116 109 101 93 85 77 68 60 51 42 33 23 
157 159 160 159 157 153 149 143 137 131 123 115 107 99 91 82 73 64 55 46 36 27 
166 169 170 169 166 162 157 151 145 137 130 121 113 104 95 86 77 68 59 49 40 30 
176 179 180 179 176 171 165 159 151 143 135 127 118 109 100 90 81 71 62 52 43 33 
185 188 190 188 185 180 173 165 157 149 140 131 122 112 103 93 84 74 65 55 45 35 
193 198 200 198 193 187 180 171 162 153 144 135 125 115 106 96 86 77 67 57 47 37 
201 207 210 207 201 193 185 176 166 157 147 137 128 118 108 98 88 78 68 58 48 38 
207 215 220 215 207 198 188 179 169 159 149 139 129 119 109 99 89 79 69 59 49 39 
210 220 230 220 210 200 190 180 170 160 150 140 130 120 110 100 90 80 70 60 50 40 
207 215 220 215 207 198 188 179 169 159 149 139 129 119 109 99 89 79 69 59 49 39 
201 207 210 207 201 193 185 176 166 157 147 137 128 118 108 98 88 78 68 58 48 38 
193 198 200 198 193 187 180 171 162 153 144 135 125 115 106 96 86 77 67 57 47 37 
185 188 190 188 185 180 173 165 157 149 140 131 122 112 103 93 84 74 65 55 45 35 
176 179 180 179 176 171 165 159 151 143 135 127 118 109 100 90 81 71 62 52 43 33 
166 169 170 169 166 162 157 151 145 137 130 121 113 104 95 86 77 68 59 49 40 30 
157 159 160 159 157 153 149 143 137 131 123 115 107 99 91 82 73 64 55 46 36 27 
