112 120 127 134 140 146 152 156 160 162 164 165 164 162 160 156 152 146 140 134 127 120 
118 126 134 141 148 155 160 165 169 172 174 175 174 172 169 165 160 155 148 141 134 126 
124 132 140 148 156 162 168 174 178 182 184 185 184 182 178 174 168 162 156 148 140 132 
129 138 146 155 162 170 176 182 187 191 194 195 194 191 187 182 176 170 162 155 146 138 
134 143 152 160 168 176 184 190 196 201 204 205 204 201 196 190 184 176 168 160 152 143 
137 147 156 165 174 182 190 198 205 210 213 215 213 210 205 198 190 182 174 165 156 147 
140 150 160 169 178 187 196 205 212 218 223 225 223 218 212 205 196 187 178 169 160 150 
143 153 162 172 182 191 201 210 218 226 232 235 232 226 218 210 201 191 182 172 162 153 
144 154 164 174 184 194 204 213 223 232 240 245 240 232 223 213 204 194 184 174 164 154 
145 155 165 175 185 195 205 215 225 235 245 255 245 235 225 215 205 195 185 175 165 155 
144 154 164 174 184 194 204 213 223 232 240 245 240 232 223 213 204 194 184 174 164 154 
143 153 162 172 182 191 201 210 218 226 232 235 232 226 218 210 201 191 182 172 162 153 
140 150 160 169 178 187 196 205 212 218 223 225 223 218 212 205 196 187 178 169 160 150 
137 147 156 165 174 182 190 198 205 210 213 215 213 210 205 198 190 182 174 165 156 147 
134 143 152 160 168 176 184 190 196 201 204 205 204 201 196 190 184 176 168 160 152 143 
129 138 146 155 162 170 176 182 187 191 194 195 194 191 187 182 176 170 162 155 146 138 
124 132 140 148 156 162 168 174 178 182 184 185 184 182 178 174 168 162 156 148 140 132 
