113 114 113 112 110 108 105 101 97 92 87 81 75 69 62 56 48 41 33 25 17 9 
123 124 123 122 120 117 114 110 106 101 95 89 83 77 70 62 55 47 39 31 23 15 
133 134 133 132 130 127 124 119 115 109 104 97 91 84 77 69 61 54 45 37 29 20 
143 144 143 142 139 136 133 128 123 117 111 105 98 91 83 75 67 59 51 43 34 25 
153 154 153 152 149 146 142 137 131 125 119 112 105 97 89 81 73 65 56 48 39 30 
163 164 163 161 159 155 151 145 139 133 126 119 111 104 95 87 79 70 61 52 43 34 
173 174 173 171 168 164 159 154 147 140 133 125 117 109 101 92 84 75 66 57 47 38 
183 184 183 181 177 173 167 161 155 147 139 131 123 115 106 97 88 79 70 60 51 42 
193 194 193 190 186 181 175 169 161 154 145 137 128 119 110 101 92 83 73 64 54 45 
203 204 203 200 195 189 183 175 167 159 151 142 133 124 114 105 95 86 76 67 57 47 
212 214 212 209 204 197 189 181 173 164 155 146 136 127 117 108 98 89 79 69 59 50 
222 224 222 217 211 204 195 186 177 168 159 149 139 130 120 110 101 91 81 71 61 51 
231 234 231 225 217 209 200 190 181 171 161 152 142 132 122 112 102 92 82 72 62 53 
239 244 239 231 222 212 203 193 183 173 163 153 143 133 123 113 103 93 83 73 63 53 
244 254 244 234 224 214 204 194 184 174 164 154 144 134 124 114 104 94 84 74 64 54 
239 244 239 231 222 212 203 193 183 173 163 153 143 133 123 113 103 93 83 73 63 53 
231 234 231 225 217 209 200 190 181 171 161 152 142 132 122 112 102 92 82 72 62 53 
