104 105 104 103 102 99 96 93 89 85 80 74 68 62 56 49 42 35 28 20 12 5 
114 115 114 113 111 109 106 102 98 93 88 82 76 70 63 57 49 42 34 26 18 10 
124 125 124 123 121 118 115 111 107 102 96 90 84 78 71 63 56 48 40 32 24 16 
134 135 134 133 131 128 125 120 116 110 105 98 92 85 78 70 62 55 46 38 30 21 
144 145 144 143 140 137 134 129 124 118 112 106 99 92 84 76 68 60 52 44 35 26 
154 155 154 153 150 147 143 138 132 126 120 113 106 98 90 82 74 66 57 49 40 31 
164 165 164 162 160 156 152 146 140 134 127 120 112 105 96 88 80 71 62 53 44 35 
174 175 174 172 169 165 160 155 148 141 134 126 118 110 102 93 85 76 67 58 48 39 
184 185 184 182 178 174 168 162 156 148 140 132 124 116 107 98 89 80 71 61 52 43 
194 195 194 191 187 182 176 170 162 155 146 138 129 120 111 102 93 84 74 65 55 46 
204 205 204 201 196 190 184 176 168 160 152 143 134 125 115 106 96 87 77 68 58 48 
213 215 213 210 205 198 190 182 174 165 156 147 137 128 118 109 99 90 80 70 60 51 
223 225 223 218 212 205 196 187 178 169 160 150 140 131 121 111 102 92 82 72 62 52 
232 235 232 226 218 210 201 191 182 172 162 153 143 133 123 113 103 93 83 73 63 54 
240 245 240 232 223 213 204 194 184 174 164 154 144 134 124 114 104 94 84 74 64 54 
245 255 245 235 225 215 205 195 185 175 165 155 145 135 125 115 105 95 85 75 65 55 
240 245 240 232 223 213 204 194 184 174 164 154 144 134 124 114 104 94 84 74 64 54 
