HCCAACCCCCCCCCCCCC
CCCCTTCCCCCCCCCCCC
CCCACCCCCCCCCCCCCC
TTCACCCCCCCCCCCCCC
TCCAAACCCCCCCCCCCC
TCCACTCCCCCCCCCCCC
TTCCCCCCCCCCCCCCCC
TTTACCCCCCCCCCCCCC
CCCCCCCCCCCCCCCCCC
CCCCCCCCCCCCCCCCCC
CCCCCCCCCCCCCCCCCC
CCCCCCCCCCCCCCCCCC
CCCCCCCCCCCCCCCCCC
CCCCCCCCCCCCCCCCCC
CCCCCCCCCCCCCCCCCC
